1001111111111111
1000000000000001
1004440002222001
1004440002222001
1000000002222001
1000000000000001
1004400000000001
1004400000000001
1000000000000001
1000000000000001
1000000000000001
1111111111111111