24 24 24 24 24 24 24 24 24 24 24 24 24 24 24 24 24 24 24 24 24 24 24 24 24 24 24 24 24 24 24 24 24 24 24 24 24 24 24 24 24 24 24 24 24 24 24 24 24 24 
24 24 24 24 24 24 24 24 24 24 24 24 24 24 23 24 24 24 24 24 24 24 24 24 24 24 24 24 24 24 24 24 24 24 24 24 24 24 24 24 24 24 24 24 24 24 24 24 24 24 
24 24 24 24 24 24 24 23 24 24 24 24 24 24 24 24 24 24 24 24 24 24 24 24 24 23 24 24 24 24 24 24 24 23 24 24 24 24 24 24 24 24 24 24 24 24 24 24 24 24 
24 24 24 24 23 24 24 24 24 24 24 23 24 24 24 24 24 24 23 24 24 24 24 24 24 24 24 23 24 24 24 24 24 24 24 24 24 24 24 24 24 23 24 24 24 24 24 24 24 24  
24 24 24 24 24 24 24 24 24 23 24 24 24 24 24 23 24 24 24 24 24 24 24 23 24 24 24 24 24 24 24 23 24 24 23 24 24 24 23 24 24 24 24 24 24 24 24 24 24 24 
24 24 24 24 24 24 24 24 24 24 24 24 24 24 24 24 24 24 24 24 24 23 24 24 24 24 24 24 24 23 24 24 24 24 24 24 23 24 24 24 24 24 24 23 24 24 24 24 24 24  
24 24 24 24 24 23 22 20 20 20 20 20 20 20 23 24 24 24 22 20 20 20 20 20 20 20 20 23 24 24 24 22 20 20 20 20 20 20 20 20 20 20 23 24 24 24 24 24 24 24 
24 24 24 24 24 24 18 04 01 01 01 01 01 04 19 20 20 20 21 04 10 10 11 10 10 10 10 19 20 20 20 21 04 10 35 33 33 33 33 33 33 36 17 24 24 23 24 24 24 24 
24 24 23 24 24 24 18 04 01 03 03 03 01 04 04 04 04 04 04 04 10 14 15 15 15 16 10 04 04 04 04 04 04 04 31 26 26 26 26 26 26 30 17 24 24 24 24 24 24 24
24 24 24 24 24 24 18 04 01 03 03 03 01 04 04 04 04 04 04 04 10 17 24 24 24 18 10 04 04 04 04 04 04 04 31 26 26 26 26 26 26 30 17 24 24 24 24 24 24 24 
24 24 24 23 24 24 18 04 01 03 03 03 01 04 04 04 04 04 04 04 10 17 24 24 24 18 11 04 04 04 04 04 04 04 31 26 26 26 26 26 26 30 17 24 23 24 24 24 24 24 
24 24 24 24 23 24 18 04 01 03 03 03 01 04 04 04 04 04 04 04 10 19 20 20 20 21 10 04 04 04 04 04 04 04 31 26 26 26 26 26 26 30 17 24 24 24 24 24 24 24 
24 24 24 24 24 24 18 04 01 01 03 01 01 04 04 04 04 04 04 04 11 10 35 33 36 10 10 04 04 04 04 04 04 04 37 28 28 29 26 27 28 38 17 23 24 24 24 24 24 24 
24 24 24 24 24 24 18 04 04 04 10 04 04 04 04 04 04 04 04 04 04 04 31 26 30 04 04 04 04 04 04 04 04 04 04 04 04 31 26 30 14 15 25 24 24 24 24 24 24 24 
24 24 24 24 23 24 18 04 04 04 10 04 04 04 04 04 04 04 04 04 04 04 31 26 30 04 04 04 04 04 04 04 04 04 04 04 04 31 26 30 17 24 24 24 24 23 24 24 24 24 
24 24 24 24 24 24 24 15 16 04 10 04 04 04 04 04 04 04 04 04 04 04 31 26 30 04 04 04 04 04 04 04 04 04 04 04 04 31 26 30 17 24 24 24 24 24 24 24 24 24 
24 24 24 24 24 24 24 24 18 04 10 04 04 04 04 04 04 04 04 04 04 04 31 26 30 04 04 04 04 04 04 04 04 04 04 04 04 31 26 30 17 24 24 24 24 24 23 24 24 24 
24 24 23 24 24 24 24 22 21 04 10 04 04 04 04 04 04 04 04 04 04 04 31 26 30 04 04 04 04 04 04 04 04 04 04 35 33 34 26 30 17 24 24 23 24 24 24 24 24 24 
24 24 24 24 24 24 24 18 10 10 10 04 04 04 04 04 04 04 04 04 04 04 31 26 30 04 04 04 04 04 04 04 04 04 04 31 26 26 26 30 17 24 24 24 24 24 24 24 24 24 
24 24 24 23 24 24 24 18 10 04 04 04 04 04 04 04 04 04 04 04 04 10 31 26 30 10 04 04 04 04 04 04 04 04 04 31 26 27 28 38 17 24 23 24 24 24 24 24 24 24 
24 24 24 24 24 24 24 18 10 04 04 04 10 35 33 33 33 33 33 33 33 33 34 26 32 33 33 33 33 33 33 33 33 33 33 34 26 30 10 04 17 24 24 24 24 24 24 24 24 24 
24 24 24 24 24 23 24 18 10 04 04 04 11 31 26 26 26 26 26 26 26 26 26 26 26 26 26 26 26 26 26 26 26 26 26 26 26 30 10 14 25 24 24 24 24 24 24 24 24 24 
24 24 24 24 24 24 23 18 10 10 04 04 10 37 28 28 28 28 28 28 28 28 29 26 27 28 28 28 28 28 28 28 28 28 28 29 26 30 10 17 24 23 24 24 24 24 24 24 24 24 
24 24 24 24 24 24 24 24 16 10 04 04 10 04 04 04 04 04 04 04 04 10 31 26 30 10 04 04 04 04 04 04 04 04 04 31 26 30 10 17 24 24 24 24 23 24 24 24 24 24 
24 24 24 24 24 24 24 24 18 10 04 04 10 04 04 04 04 04 04 04 04 04 31 26 30 04 04 04 04 04 04 04 04 04 04 31 26 30 11 17 24 24 24 24 24 24 24 24 24 24 
24 24 24 24 24 23 24 22 21 10 04 04 10 10 10 04 04 04 04 04 04 04 31 26 30 04 04 04 04 04 04 04 04 04 04 31 26 30 10 17 24 24 24 23 24 24 24 24 24 24 
24 24 24 24 24 24 24 18 10 10 04 04 04 04 10 04 04 04 04 04 04 04 31 26 30 04 04 04 04 04 04 04 04 04 04 31 26 30 10 17 24 24 24 24 24 24 24 24 24 24 
24 24 24 23 24 24 24 18 10 04 04 04 04 04 10 04 04 04 04 04 04 04 31 26 30 04 04 10 04 04 04 04 04 04 04 31 26 30 10 17 24 23 24 24 24 24 24 24 24 24 
24 24 24 24 24 24 24 18 10 04 04 04 04 04 10 04 04 04 04 04 04 04 31 26 30 04 04 04 04 04 10 04 04 04 04 31 26 30 10 17 24 24 24 24 24 24 24 24 24 24 
24 24 24 24 24 24 23 18 10 10 10 10 10 10 10 04 04 04 04 04 04 04 31 26 30 04 04 04 04 04 10 04 04 04 04 37 28 38 10 17 24 24 24 24 23 24 24 24 24 24 
24 24 24 24 24 24 24 18 10 10 11 10 10 10 10 04 04 04 04 04 04 04 31 26 30 04 04 04 04 04 04 04 04 04 04 04 10 04 14 25 24 24 23 24 24 24 24 24 24 24 
24 24 24 24 24 24 24 24 16 10 10 10 10 10 10 04 04 04 04 04 04 04 31 26 30 04 04 04 04 04 04 04 04 04 04 10 10 10 17 24 24 24 24 24 24 24 24 24 24 24 
24 24 24 24 24 23 24 24 18 10 10 10 10 11 10 04 04 04 04 04 04 04 31 26 30 04 04 04 04 04 04 04 04 04 04 10 10 10 17 24 24 24 24 24 24 24 23 24 24 24 
24 24 24 24 24 24 24 24 18 11 10 10 10 10 10 04 04 04 04 04 04 04 31 26 30 04 04 04 04 04 04 04 04 04 04 10 10 11 17 24 24 23 24 24 24 24 24 24 24 24 
24 24 24 24 24 24 24 24 18 10 10 10 10 10 10 04 04 04 04 04 04 04 31 26 30 04 04 04 04 04 04 04 04 04 04 10 10 10 17 24 24 24 24 24 24 24 24 24 24 24 
24 24 24 24 23 24 24 22 21 04 04 04 04 04 04 04 04 04 04 04 04 04 37 28 38 04 04 04 04 04 04 04 04 04 04 11 10 10 19 23 24 24 24 24 24 24 24 24 24 24 
24 24 24 24 24 24 24 18 04 04 04 04 04 04 04 04 04 04 04 10 10 10 10 10 10 10 10 04 04 04 04 04 04 04 10 10 10 10 10 19 23 24 24 24 23 24 24 24 24 24 
24 24 24 24 24 24 23 18 04 04 04 04 04 04 04 04 04 04 10 10 10 10 10 10 10 10 10 10 04 04 10 04 04 10 10 10 10 10 10 10 17 24 24 24 24 24 24 24 24 24 
24 24 24 24 24 24 24 18 10 04 04 04 04 04 04 04 04 04 10 11 10 10 10 10 10 11 10 10 04 04 04 04 10 10 10 10 10 11 10 10 17 24 23 24 24 24 24 24 24 24 
24 24 24 24 24 24 24 18 10 04 04 04 04 10 04 04 04 04 10 10 11 10 10 10 10 10 10 10 10 04 04 04 10 10 10 10 10 04 10 10 17 24 24 24 24 24 24 24 24 24 
24 24 23 24 24 24 24 18 10 04 04 04 04 04 04 04 04 04 10 10 10 10 10 10 10 10 10 10 10 10 10 10 10 10 04 10 10 10 10 10 17 24 24 24 24 23 24 24 24 24 
24 24 24 24 24 24 24 18 10 04 04 04 04 10 04 14 15 15 16 10 10 10 10 10 11 10 10 14 15 15 16 10 10 10 10 10 10 10 11 10 17 24 24 24 24 24 24 23 24 24 
24 24 24 24 24 24 24 18 04 04 04 04 04 04 14 25 24 24 24 16 10 10 10 10 10 10 14 25 24 24 18 10 10 04 10 10 04 10 10 10 17 24 24 24 24 24 24 24 24 24 
24 24 24 24 23 24 24 24 15 15 15 15 15 15 25 24 24 24 24 24 15 15 15 15 15 15 25 24 23 24 24 16 10 11 10 10 10 10 14 15 25 24 23 24 24 24 24 24 24 24 
24 24 24 24 24 24 24 24 24 24 24 24 24 24 24 24 24 24 23 24 24 24 24 24 24 24 24 24 24 24 24 24 15 15 15 15 15 15 25 24 24 24 24 24 24 24 23 24 24 24 
24 24 24 24 24 24 24 24 24 24 24 23 24 24 24 24 23 24 24 24 24 24 24 24 24 24 24 24 24 24 24 24 24 24 24 24 23 24 24 24 24 24 24 23 24 24 24 24 24 24 
24 24 24 24 24 24 23 24 24 24 24 24 24 24 24 24 24 24 24 24 24 24 24 24 23 24 24 24 24 23 24 24 24 24 24 24 24 24 24 24 24 24 24 24 24 24 24 24 24 24 
24 24 24 24 24 24 24 24 24 24 24 24 24 24 23 24 24 24 24 24 23 24 24 24 24 24 24 24 24 24 24 24 23 24 24 24 24 24 24 23 24 24 24 24 24 24 24 24 24 24 
24 24 24 24 24 24 24 24 24 24 24 24 24 24 24 24 24 24 24 24 24 24 24 24 24 24 24 23 24 24 24 24 24 24 24 24 24 24 24 24 24 24 24 24 24 23 24 24 24 24 
24 24 24 24 24 24 24 24 24 24 24 24 24 24 24 24 24 24 24 24 24 24 24 24 24 24 24 24 24 24 24 24 24 24 24 24 24 24 24 24 24 24 24 24 24 24 24 24 24 24 