24 24 24 24 24 24 24 24 24 24 24 24 24 24 24 24 24 24 24 24 24 24 24 24 24 24 24 24 24 24 24 24 24 24 24 24 24 24 24 24 24 24 24 24 24 24 24 24 24 24 
24 24 24 24 24 24 24 24 24 24 24 24 24 24 23 24 24 24 24 24 24 24 24 24 24 24 24 24 24 24 24 24 24 24 24 24 24 24 24 24 24 24 24 24 24 24 24 24 24 24 
24 24 24 24 24 24 24 23 24 24 24 24 24 24 24 24 24 24 24 24 24 24 24 24 24 23 24 24 24 24 24 24 24 23 24 24 24 24 24 24 24 24 24 24 24 24 24 24 24 24 
24 24 24 24 23 24 24 24 24 24 24 23 24 24 24 24 24 24 23 24 24 24 24 24 24 24 24 23 24 24 24 24 24 24 24 24 24 24 24 24 24 23 24 24 24 24 24 24 24 24  
24 24 24 24 24 24 24 24 24 23 24 24 24 24 24 23 24 24 24 24 24 24 24 23 24 24 24 24 24 24 24 23 24 24 23 24 24 24 23 24 24 24 24 24 24 24 24 24 24 24 
24 24 24 24 24 24 24 24 24 24 24 24 24 24 24 24 24 24 24 24 24 23 24 24 24 24 24 24 24 23 24 24 24 24 24 24 23 24 24 24 24 24 24 23 24 24 24 24 24 24  
24 24 24 24 24 23 00 00 00 00 00 00 00 00 23 24 24 24 00 00 00 00 00 00 00 00 00 23 24 24 24 00 00 00 00 00 00 00 00 00 00 00 23 24 24 24 24 24 24 24 
24 24 24 24 24 24 18 04 06 06 06 06 06 04 00 00 00 00 00 04 00 00 00 00 00 00 00 00 00 00 00 00 04 10 00 05 05 05 05 05 05 01 17 24 24 23 24 24 24 24 
24 24 23 24 24 24 18 04 06 03 03 03 06 04 04 04 04 04 04 04 10 11 11 11 11 11 12 04 04 04 04 04 04 04 05 05 05 05 05 05 05 00 17 24 24 24 24 24 24 24
24 24 24 24 24 24 18 04 06 03 03 03 06 04 04 04 04 04 04 04 13 24 24 24 24 24 15 04 04 04 04 04 04 04 05 05 05 05 05 05 05 00 17 24 24 24 24 24 24 24 
24 24 24 23 24 24 18 04 06 03 03 03 06 04 04 04 04 04 04 04 13 24 24 24 24 24 15 04 04 04 04 04 04 04 05 05 05 05 05 05 05 00 17 24 23 24 24 24 24 24 
24 24 24 24 23 24 18 04 06 03 03 03 06 04 04 04 04 04 04 04 13 24 24 24 24 24 15 04 04 04 04 04 04 04 05 05 05 05 05 05 05 00 17 24 24 24 24 24 24 24 
24 24 24 24 24 24 18 04 06 06 03 06 06 04 04 04 04 04 04 04 16 17 17 17 17 17 18 04 04 04 04 04 04 04 00 01 01 00 05 00 01 00 17 23 24 24 24 24 24 24 
24 24 24 24 24 24 18 04 04 04 10 04 04 04 04 04 04 04 04 04 04 04 05 05 00 04 04 04 04 04 04 04 04 04 04 04 04 05 05 00 14 15 00 24 24 24 24 24 24 24 
24 24 24 24 23 24 18 04 04 04 10 04 04 04 04 04 04 04 04 04 04 04 05 05 00 04 04 04 04 04 04 04 04 04 04 04 04 05 05 00 17 24 24 24 24 23 24 24 24 24 
24 24 24 24 24 24 24 15 16 04 10 04 04 04 04 04 04 04 04 04 04 04 05 05 00 04 04 04 04 04 04 04 04 04 04 04 04 05 05 00 17 24 24 24 24 24 24 24 24 24 
24 24 24 24 24 24 24 24 18 04 10 04 04 04 04 04 04 04 04 04 04 04 05 05 00 04 04 04 04 04 04 04 04 04 04 04 04 05 05 00 17 24 24 24 24 24 23 24 24 24 
24 24 23 24 24 24 24 00 00 04 10 04 04 04 04 04 04 04 04 04 04 04 05 05 00 04 04 04 04 04 04 04 04 04 04 00 05 00 05 00 17 24 24 23 24 24 24 24 24 24 
24 24 24 24 24 24 24 18 10 10 10 04 04 04 04 04 04 04 04 04 04 04 05 05 00 04 04 04 04 04 04 04 04 04 04 05 05 05 05 00 17 24 24 24 24 24 24 24 24 24 
24 24 24 23 24 24 24 18 10 04 04 04 04 04 04 04 04 04 04 04 04 10 05 05 00 10 04 04 04 04 04 04 04 04 04 05 05 00 01 00 17 24 23 24 24 24 24 24 24 24 
24 24 24 24 24 24 24 18 10 04 04 04 10 00 05 05 05 05 05 05 05 05 00 05 05 05 05 05 05 05 05 05 05 05 05 00 05 00 10 04 17 24 24 24 24 24 24 24 24 24 
24 24 24 24 24 23 24 18 10 04 04 04 11 05 05 05 05 05 05 05 05 05 05 05 05 05 05 05 05 05 05 05 05 05 05 05 05 00 10 14 00 24 24 24 24 24 24 24 24 24 
24 24 24 24 24 24 23 18 10 10 04 04 10 00 01 01 01 01 01 01 01 01 00 05 00 01 01 01 01 01 01 01 01 01 01 00 05 00 10 17 24 23 24 24 24 24 24 24 24 24 
24 24 24 24 24 24 24 24 16 10 04 04 10 04 04 04 04 04 04 04 04 00 05 05 00 00 04 04 04 04 04 04 04 04 04 05 05 00 10 17 24 24 24 24 23 24 24 24 24 24 
24 24 24 24 24 24 24 24 18 10 04 04 10 04 04 04 04 04 04 04 04 04 05 05 00 04 04 04 04 04 04 04 04 04 04 05 05 00 11 17 24 24 24 24 24 24 24 24 24 24 
24 24 24 24 24 23 24 00 00 10 04 04 10 10 10 04 04 04 04 04 04 04 05 05 00 04 04 04 04 04 04 04 04 04 04 05 05 00 10 17 24 24 24 23 24 24 24 24 24 24 
24 24 24 24 24 24 24 18 10 10 04 04 04 04 10 04 04 04 04 04 04 04 05 05 00 04 04 04 04 04 04 04 04 04 04 05 05 00 10 17 24 24 24 24 24 24 24 24 24 24 
24 24 24 23 24 24 24 18 10 04 04 04 04 04 10 04 04 04 04 04 04 04 05 05 00 04 04 10 04 04 04 04 04 04 04 05 05 00 10 17 24 23 24 24 24 24 24 24 24 24 
24 24 24 24 24 24 24 18 10 04 04 04 04 04 10 04 04 04 04 04 04 04 05 05 00 04 04 04 04 04 10 04 04 04 04 05 05 00 10 17 24 24 24 24 24 24 24 24 24 24 
24 24 24 24 24 24 23 18 10 10 10 10 10 10 10 04 04 04 04 04 04 04 05 05 00 04 04 04 04 04 10 04 04 04 04 00 01 00 10 17 24 24 24 24 23 24 24 24 24 24 
24 24 24 24 24 24 24 18 10 10 11 10 10 10 10 04 04 04 04 04 04 04 05 05 00 04 04 04 04 04 04 04 04 04 04 04 10 04 14 00 24 24 23 24 24 24 24 24 24 24 
24 24 24 24 24 24 24 24 16 10 10 10 10 10 10 04 04 04 04 04 04 04 05 05 00 04 04 04 04 04 04 04 04 04 04 10 10 10 17 24 24 24 24 24 24 24 24 24 24 24 
24 24 24 24 24 23 24 24 18 10 10 10 10 11 10 04 04 04 04 04 04 04 05 05 00 04 04 04 04 04 04 04 04 04 04 10 10 10 17 24 24 24 24 24 24 24 23 24 24 24 
24 24 24 24 24 24 24 24 18 11 10 10 10 10 10 04 04 04 04 04 04 04 05 05 00 04 04 04 04 04 04 04 04 04 04 10 10 11 17 24 24 23 24 24 24 24 24 24 24 24 
24 24 24 24 24 24 24 24 18 10 10 10 10 10 10 04 04 04 04 04 04 04 05 05 00 04 04 04 04 04 04 04 04 04 04 10 10 10 17 24 24 24 24 24 24 24 24 24 24 24 
24 24 24 24 23 24 24 00 00 04 04 04 04 04 04 04 04 04 04 04 04 04 00 01 00 04 04 04 04 04 04 04 04 04 04 11 10 10 00 23 24 24 24 24 24 24 24 24 24 24 
24 24 24 24 24 24 24 18 04 04 04 04 04 04 04 04 04 04 04 10 10 10 10 10 10 10 10 04 04 04 04 04 04 04 10 10 10 10 10 00 23 24 24 24 23 24 24 24 24 24 
24 24 24 24 24 24 23 18 04 04 04 04 04 04 04 04 04 04 10 10 10 10 10 10 10 10 10 10 04 04 10 04 04 10 10 10 10 10 10 10 17 24 24 24 24 24 24 24 24 24 
24 24 24 24 24 24 24 18 10 04 04 04 04 04 04 04 04 04 10 11 10 10 10 10 10 11 10 10 04 04 04 04 10 10 10 10 10 11 10 10 17 24 23 24 24 24 24 24 24 24 
24 24 24 24 24 24 24 18 10 04 04 04 04 10 04 04 04 04 10 10 11 10 10 10 10 10 10 10 10 04 04 04 10 10 10 10 10 04 10 10 17 24 24 24 24 24 24 24 24 24 
24 24 23 24 24 24 24 18 10 04 04 04 04 04 04 04 04 04 10 10 10 10 10 10 10 10 10 10 10 10 10 10 10 10 04 10 10 10 10 10 17 24 24 24 24 23 24 24 24 24 
24 24 24 24 24 24 24 18 10 04 04 04 04 10 04 14 15 15 16 10 10 10 10 10 11 10 10 14 15 15 16 10 10 10 10 10 10 10 11 10 17 24 24 24 24 24 24 23 24 24 
24 24 24 24 24 24 24 18 04 04 04 04 04 04 14 00 24 24 24 16 10 10 10 10 10 10 14 00 24 24 18 10 10 04 10 10 04 10 10 10 17 24 24 24 24 24 24 24 24 24 
24 24 24 24 23 24 24 24 15 15 15 15 15 15 00 24 24 24 24 24 15 15 15 15 15 15 00 24 23 24 24 16 10 11 10 10 10 10 14 15 00 24 23 24 24 24 24 24 24 24 
24 24 24 24 24 24 24 24 24 24 24 24 24 24 24 24 24 24 23 24 24 24 24 24 24 24 24 24 24 24 24 24 15 15 15 15 15 15 00 24 24 24 24 24 24 24 23 24 24 24 
24 24 24 24 24 24 24 24 24 24 24 23 24 24 24 24 23 24 24 24 24 24 24 24 24 24 24 24 24 24 24 24 24 24 24 24 23 24 24 24 24 24 24 23 24 24 24 24 24 24 
24 24 24 24 24 24 23 24 24 24 24 24 24 24 24 24 24 24 24 24 24 24 24 24 23 24 24 24 24 23 24 24 24 24 24 24 24 24 24 24 24 24 24 24 24 24 24 24 24 24 
24 24 24 24 24 24 24 24 24 24 24 24 24 24 23 24 24 24 24 24 23 24 24 24 24 24 24 24 24 24 24 24 23 24 24 24 24 24 24 23 24 24 24 24 24 24 24 24 24 24 
24 24 24 24 24 24 24 24 24 24 24 24 24 24 24 24 24 24 24 24 24 24 24 24 24 24 24 23 24 24 24 24 24 24 24 24 24 24 24 24 24 24 24 24 24 23 24 24 24 24 
24 24 24 24 24 24 24 24 24 24 24 24 24 24 24 24 24 24 24 24 24 24 24 24 24 24 24 24 24 24 24 24 24 24 24 24 24 24 24 24 24 24 24 24 24 24 24 24 24 24 